A12111█213
213█1█1131
11█2311112
█1113█2112
111█131█12
2█1112█311
31121█1112
█121█31221
1113█12111
213█2113B1