##########
#A       #
# ###### #
# #    # #
# # ## # #
# # ## # #
# #    #B#
# ###### #
#        #
##########