##########
#A       #
# ## ### #
#    # # #
#### # # #
#    # # #
# #### # #
#      # #
######## #
#        B
##########
